11111111111111111111
1P000000000100000001
11111110111101111101
10000S00100000000101
10111111101111110101
10100000000010000001
10101111111010111111
10001000G00010000001
11101011111111101101
1000100000G000001001
10111111101110111001
10000010001000100001
10111010111011101101
100000000000000000E1
11111111111111111111