11111111111111111111
100000100000000S00E1
10111010111111111101
101000001000G0000001
10101111101111101111
10000000001000000001
11111110111011111101
10000000100000000001
10111111101111111101
100000000000G0000001
10111011111111101101
10100000000000001001
10111111111011111001
1P000000000000000001
11111111111111111111