11111111111111111111
100000000000000000E1
10110011001100110001
10110011001100110001
10000000000000000001
10001111111111110001
10001000000000010001
100010000P0000010001
10001000000000010001
10001111001111110001
10000000000000000001
11001100G00110011001
11001100000110011001
11000000000000000001
11111111111111111111