11111111111111111111
1P100000000000000001
10101111111111111101
10101000000000000101
10101011111111110101
1010101000000G010101
10101010111111010101
101010101E0001010101
10101010111101010101
10101010000001010101
10101011111111010101
10101000000000010101
10101111111111110101
10000000000000000101
11111111111111111111