11111111111111111111
1P000001000000000001
11111011011111111101
10000000000000000101
10111111101111110101
10100000001000000001
10101111111011111101
10000000G00000000001
11111011111110111111
10000010000000100001
10111110111110101101
1000000000G000000101
10111111111110111101
100000000000000000E1
11111111111111111111