11111111111111111111
1P000010000000000001
11111010111111111101
10000010100000000001
10111110101111101111
10000000101000000001
10111111101011111101
10000000001000000001
11111111111111111101
10000000000000000001
10111111101111111111
10100000000000000001
10101111111G11111101
100000000000000000E1
11111111111111111111